111111111111111111111111111111111111111111111111111
1P00000000000000C00000000C00000000000000000000000E1
100001111000000000000001111100000000000C00000000001
100000000000000000000000000000000000000000000000001
10000C00001111100000000000000000001111000000C000001
100000000000000000000000000000000000000000000000001
100000011110000000000111100000000000000000000000001
10000000000000000C000000000000011110000000000000001
100000000000000000000000000000000000000000000C00001
100000000000000011111111000000000000000000000000001
100000000000000000000000000000000000000000000000001
10000C00000000000000001110000000000000C000000000001
100000000000001111100000000000000000000000000000001
100000000000000000000000000000000000000000000000001
100000000000000000000000000000001111100000000000001
1000000000000000C0000000000000000000000000000000001
100000000000000000000000011100000000000000000000001
1000000000000000000000000000000000000000C0000000001
1C00000000000000000000000000000000000000000000000C1
111111111111111111111111111111111111111111111111111
