11111
1P0C1
11111
1E001
1C001
11111