11111111111111111111
100000Z0000001Z000Z1
100000000C000000C001
110111Z00011110000Z1
1E000000001111Z00001
111111110001110000Z1
100Z0000Z000C10Z0001
10C00000000001000001
1000Z0Z00Z111100Z001
11011100C00000000001
1C00000000Z0000000P1
11111111111111111111
