111111
100001
101C01
101001
1P10E1
111111