11111111111111111111111111111
1E0000000000000C00000C0000001
1010010100100Z0010100100000Z1
1010010Z10101010Z010010000001
1P0000000C00C00000Z0000000001
11111111111111111111111111111