11111111111111
1E1C1C1C1C10C1
10000000000001
11111111111101
100000000000C1
10111111111111
100000000000P1
11111111111111
